----------
-++++++++-
-+-+xx+x--
--xxxxxx--
--x++++xx-
--x----x--
++++++++++
++++++++++
-+x++++++-
----------