--------------------
-++++++++++++++++++-
-+Rxxxx++++xxxxxR+-
-+++xx+++--+++xx+++-
-xx+--+x----x+--+xx-
-xx+--+x----x+--+xx-
-+++xx+++--+++xx+++-
-+xxxxxx++++xxxxxx+-
-+++--++++++++--+++-
-++----++xx++----++-
-++----++xx++----++-
-+++--++++++++--+++-
-+xxxxxx++++xxxxxx+-
-+++xx+++--+++xx+++-
-xx+--+x----x+--+xx-
-xx+--+x----x+--+xx-
-+++xx+++--+++xx+++-
-+Rxxxxx++++xxxxxR+-
-++++++++++++++++++-
--------------------