----------
-+++++++--
--++xx+x--
--++++++--
--x++++xx-
--xxxxxx--
--xxxxxx--
--x+++++--
-+x++++++-
----------