--------------------
-++++++++++++++++++-
-+Rxxxx++++xxxxxR+-
-++-xx+++xx+++xx-++-
-xx+-x+xxxxxx+x-+xx-
-xx+x-xxxxxxxx-x+xx-
-+++xx-++xx++-xx+++-
-+xxxxx-+xx+-xxxxx+-
-+++x-++-xx-++-x+++-
-++-xx-+x--x+-xx-++-
-++-xx-+x--x+-xx-++-
-+++x-++-xx-++-x+++-
-+xxxxx-+xx+-xxxxx+-
-+++xx-++xx++-xx+++-
-xx+x-xxxxxxxx-x+xx-
-xx+-x+xxxxxx+x-+xx-
-++-xx+++xx+++xx-++-
-+Rxxxxx++++xxxxxR+-
-++++++++++++++++++-
--------------------